r......................R
r...W....###...........R
r..++..........@.......R
r..................X...R
r...W..............@...R
r..++..................R
r......................R
r...k..................R
r...+...CCC..W.........R
r.......+++............R
r............+.........R
r...............+......k
.......................+
.1...W..W..W..W..W..W..R
@@@..@..@..@..@..@..@...
12
Get the shield and try to finish