....................
W........###...z...X
+..............@...@
....................
W...................
+...................
...W...z....W.......
W..+...+....+.......
+...................
....................
W...W...z......W...W
+...@...@......@...k
....................
.1...W..z..W..z..W..
@@@..@..@..@..@..@..
12
Quickly!!!