bP
.................q
.....
............................................................................................p
=========================.........................................=============================
=========================......................................================================
=========================...................................===================================
=========================................................======================================
=========================.............................=========================================
=========================............E.............============================================
=========================.......................===============================================
=========================....................==================================================
===============================================================================================
+....+....+....+....+....+....+....+....+....+....+....+....+....+....+....+....+....+....+....
.
Room