...................................................................................
........BB...........BB...B.B......................................................
........BB.........BBB..BB..B......................................................
........BB.......B..........B......................................................
........BBB......BB.B.B.B...B......................................................
1..^....^BB...............B.B......................................................
...^BBBB^BBB..BB..B.BBB..B..Bz...............................................k.....
...^BBBB^BBB.BBBB.B.....B..BBttttttttttttttttttttttttttttttttttttttttttttttttt.....
XXXXXXXXXXXXXXXXXXXXXXXXXXXXXXXXXXXXXXXXXXXXXXXXXXXXXXXXXXXXXXXXXXXXXXXXXXXXXXXXXXE