....................................................................................
.........BB...........BB...B.B......................................................
.........BB.........BBB..BB..B......................................................
.........BB.......B..........B......................................................
.........BBB......BB.B.B.B...B......................................................
P.TH.....HBB...............B.B......................................................
...H.....HBBB..BB..B.BBB..B..BT.....................................................
N..HB....HBBB.BBBB.B.....B..BBrrrrrrrrrrrrrrrrrrrrrrrrrrrrrrrrrrrrrrrrrrrrrrrrrS....
XXXXXXXXXXXXXXXXXXXXXXXXXXXXXXXXXXXXXXXXXXXXXXXXXXXXXXXXXXXXXXXXXXXXXXXXXXXXXXXXXXXE